15 11 
x x x x x x x x x x x x x x x 
x x x o o o o o o o o o o 3 x 
x x x o o x x o x x x x x x x 
x x x x o x x o x x x x x x x 
x x x x o x x o o o o x x x x 
x x o o o x x o x x x x x x x 
x x x o o x x o x x x x x x x 
x x x o o o o o o x x x x x x 
x 1 o o o o o o 2 x x x x x x 
x x o o o o o o o o o x x x x 
x x x x x x x x x x x x x x x