11 14 
x x x x x x x x x x x 
x x 3 o o o o o x x x 
x x o x o o o o x x x 
x x o x x x o o x x x 
x x o x x x o o x x x 
x x o o o o o o x x x 
x x o o x x o o x x x 
x x x o x x o o x x x 
x x x o x x o o x x x 
x x x o x x o o x x x 
x x x o x o o o x x x 
x x x o o o 2 o o 1 x 
x x x x x o o o x x x 
x x x x x x x x x x x